0000000000000000000000000000
0000000000000000000000000000
0000000000000000000000000000
1111111111111111111111111111
1777777777777117777777777771
1711117111117117111117111171
1811117111117117111117111181
1711117111117117111117111171
1777777777777777777777777771
1711117117111111117117111171
1711117117111111117117111171
1777777117777117777117777771
1111117111110110111117111111
1111117111110110111117111111
1111117110000000000117111111
1111117110111441110117111111
1111117110100000010117111111
0000007000100000010007000000
1111117110100000010117111111
1111117110111111110117111111
1111117110000230000117111111
1111117110111111110117111111
1111117110111111110117111111
1777777777777117777777777771
1711117111117117111117111171
1711117111117117111117111171
1877117777777007777777117781
1117117117111111117117117111
1117117117111111117117117111
1777777117777117777117777771
1711111111117117111111111171
1711111111117117111111111171
1777777777777777777777777771
1111111111111111111111111111
0000000000000000000000000000
0000000000000000000000000000