0000000000000000000000000000
0000000000000000000000000000
0000000000000000000000000000
6222222222222562222222222225
1777777777777117777777777771
1762257622257117622257622571
1711117111117117111117111171
1742237422237437422237422371
1777777777777777777777777771
1762257657622222257657622571
1742237117422562237117422371
1777777117777117777117777771
4222257142257117622317622223
1111117162237437422517111111
1111117117777777777117111111
1111117117622222257117111111
2222237437100000017437422222
7777777777100000017777777777
2222257657100000017657622222
1111117117422222237117111111
1111117117777777777117111111
1111117117622222257117111111
6222237437422562237437422225
1777777777777117777777777771
1762257622257117622257622571
1742517422237437422237162371
1777117777777007777777117771
4257117657622222257657117623
6237437117422562237117437425
1777777117777117777117777771
1762222342257117622342222571
1742222222237437422222222371
1777777777777777777777777771
4222222222222222222222222223
0000000000000000000000000000
0000000000000000000000000000