0000000000000000000000000000
0000000000000000000000000000
0000000000000000000000000000
1111111111111111111111111111
1877777777777117777777777781
1711117111117117111117111171
1711117111117117111117111171
1711117111117117111117111171
1777777777777777777777777771
1711117117111111117117111171
1711117117111111117117111171
1777777117777117777117777771
1111117111117117111117111111
1111117111117117111117111111
1111117117777777777117111111
1111117117111111117117111111
1111117117100000017117111111
7777777777100000017777777777
1111117117100000017117111111
1111117117111111117117111111
1111117117777777777117111111
1111117117111111117117111111
1111117117111111117117111111
1777777777777117777777777771
1711117111117117111117111171
1711117111117117111117111171
1777117777777007777777117771
1117117117111111117117117111
1117117117111111117117117111
1777777117777117777117777771
1711111111117117111111111171
1711111111117117111111111171
1877777777777777777777777781
1111111111111111111111111111
0000000000000000000000000000
0000000000000000000000000000